"filename", "language", "HTML", "comment", "blank", "total"
"s:\Documents\GitHub\ProStartup-Learn\courses\cs\html\general-info\external-files-table.shtml", "HTML", 37, 0, 1, 38
"s:\Documents\GitHub\ProStartup-Learn\courses\cs\html\general-info\list-lang-codes.html", "HTML", 777, 4, 0, 781
"s:\Documents\GitHub\ProStartup-Learn\courses\cs\html\html101\01-cs-introduction.html", "HTML", 140, 4, 0, 144
"s:\Documents\GitHub\ProStartup-Learn\courses\cs\html\html101\02-concepts.html", "HTML", 201, 4, 0, 205
"s:\Documents\GitHub\ProStartup-Learn\courses\cs\html\html101\03-basics-example.html", "HTML", 10, 1, 0, 11
"s:\Documents\GitHub\ProStartup-Learn\courses\cs\html\html101\03-basics.html", "HTML", 220, 4, 0, 224
"s:\Documents\GitHub\ProStartup-Learn\courses\cs\html\html101\04-text-formatting-example.html", "HTML", 27, 0, 0, 27
"s:\Documents\GitHub\ProStartup-Learn\courses\cs\html\html101\04-text-formatting.html", "HTML", 103, 4, 0, 107
"s:\Documents\GitHub\ProStartup-Learn\courses\cs\html\html101\05-block-inline-elements.html", "HTML", 58, 4, 0, 62
"s:\Documents\GitHub\ProStartup-Learn\courses\cs\html\html101\06-entities-example.html", "HTML", 16, 0, 0, 16
"s:\Documents\GitHub\ProStartup-Learn\courses\cs\html\html101\06-entities.html", "HTML", 216, 4, 0, 220
"s:\Documents\GitHub\ProStartup-Learn\courses\cs\html\html101\07-directories.html", "HTML", 132, 4, 1, 137
"s:\Documents\GitHub\ProStartup-Learn\courses\cs\html\html101\08-links-example01.html", "HTML", 13, 0, 0, 13
"s:\Documents\GitHub\ProStartup-Learn\courses\cs\html\html101\08-links-example02.html", "HTML", 12, 0, 0, 12
"s:\Documents\GitHub\ProStartup-Learn\courses\cs\html\html101\08-links-example03.html", "HTML", 14, 0, 0, 14
"s:\Documents\GitHub\ProStartup-Learn\courses\cs\html\html101\08-links-example04.html", "HTML", 14, 0, 0, 14
"s:\Documents\GitHub\ProStartup-Learn\courses\cs\html\html101\08-links-example05.html", "HTML", 14, 0, 0, 14
"s:\Documents\GitHub\ProStartup-Learn\courses\cs\html\html101\08-links.html", "HTML", 152, 4, 0, 156
"s:\Documents\GitHub\ProStartup-Learn\courses\cs\html\html101\09-images-example01.html", "HTML", 13, 0, 0, 13
"s:\Documents\GitHub\ProStartup-Learn\courses\cs\html\html101\09-images-example02.html", "HTML", 16, 0, 0, 16
"s:\Documents\GitHub\ProStartup-Learn\courses\cs\html\html101\09-images.html", "HTML", 196, 4, 0, 200
"s:\Documents\GitHub\ProStartup-Learn\courses\cs\html\html101\10-lists-example01.html", "HTML", 16, 0, 0, 16
"s:\Documents\GitHub\ProStartup-Learn\courses\cs\html\html101\10-lists-example02.html", "HTML", 36, 0, 0, 36
"s:\Documents\GitHub\ProStartup-Learn\courses\cs\html\html101\10-lists-example03.html", "HTML", 18, 0, 0, 18
"s:\Documents\GitHub\ProStartup-Learn\courses\cs\html\html101\10-lists.html", "HTML", 196, 4, 0, 200
"s:\Documents\GitHub\ProStartup-Learn\courses\cs\html\html101\11-tables-example01.html", "HTML", 23, 0, 0, 23
"s:\Documents\GitHub\ProStartup-Learn\courses\cs\html\html101\11-tables-example02.html", "HTML", 31, 0, 0, 31
"s:\Documents\GitHub\ProStartup-Learn\courses\cs\html\html101\11-tables-example03.html", "HTML", 28, 0, 0, 28
"s:\Documents\GitHub\ProStartup-Learn\courses\cs\html\html101\11-tables-example04.html", "HTML", 32, 0, 0, 32
"s:\Documents\GitHub\ProStartup-Learn\courses\cs\html\html101\11-tables.html", "HTML", 270, 4, 0, 274
"s:\Documents\GitHub\ProStartup-Learn\courses\cs\html\html101\12-next.html", "HTML", 38, 4, 0, 42
"s:\Documents\GitHub\ProStartup-Learn\courses\cs\html\html101\list-101elements.html", "HTML", 317, 4, 0, 321
"s:\Documents\GitHub\ProStartup-Learn\courses\cs\html\html102\01-cs-introduction.html", "HTML", 37, 4, 0, 41
"s:\Documents\GitHub\ProStartup-Learn\courses\cs\html\html102\02-iframe-example01.html", "HTML", 17, 0, 1, 18
"s:\Documents\GitHub\ProStartup-Learn\courses\cs\html\html102\02-iframe-example02.html", "HTML", 17, 0, 1, 18
"s:\Documents\GitHub\ProStartup-Learn\courses\cs\html\html102\02-iframe.html", "HTML", 117, 4, 0, 121
"s:\Documents\GitHub\ProStartup-Learn\courses\cs\html\html102\03-iframe-security.html", "HTML", 49, 4, 0, 53
"s:\Documents\GitHub\ProStartup-Learn\courses\cs\html\html102\04-audio-element-example01.html", "HTML", 18, 0, 0, 18
"s:\Documents\GitHub\ProStartup-Learn\courses\cs\html\html102\04-audio-element-example02.html", "HTML", 17, 0, 0, 17
"s:\Documents\GitHub\ProStartup-Learn\courses\cs\html\html102\04-audio-element.html", "HTML", 145, 4, 0, 149
"s:\Documents\GitHub\ProStartup-Learn\courses\cs\html\html102\05-audio-external-example01.html", "HTML", 11, 0, 0, 11
"s:\Documents\GitHub\ProStartup-Learn\courses\cs\html\html102\05-audio-external-example02.html", "HTML", 11, 0, 0, 11
"s:\Documents\GitHub\ProStartup-Learn\courses\cs\html\html102\05-audio-external.html", "HTML", 135, 5, 0, 140
"s:\Documents\GitHub\ProStartup-Learn\courses\cs\html\html102\06-video-element-example01.html", "HTML", 21, 0, 0, 21
"s:\Documents\GitHub\ProStartup-Learn\courses\cs\html\html102\06-video-element-example02.html", "HTML", 16, 0, 0, 16
"s:\Documents\GitHub\ProStartup-Learn\courses\cs\html\html102\06-video-element.html", "HTML", 157, 4, 0, 161
"s:\Documents\GitHub\ProStartup-Learn\courses\cs\html\html102\07-video-external-example01.html", "HTML", 11, 0, 0, 11
"s:\Documents\GitHub\ProStartup-Learn\courses\cs\html\html102\07-video-external-example02.html", "HTML", 12, 0, 0, 12
"s:\Documents\GitHub\ProStartup-Learn\courses\cs\html\html102\07-video-external.html", "HTML", 150, 5, 0, 155
"s:\Documents\GitHub\ProStartup-Learn\courses\cs\html\html102\08-next.html", "HTML", 38, 4, 0, 42
"s:\Documents\GitHub\ProStartup-Learn\courses\cs\html\html102\list-102elements.html", "HTML", 111, 4, 0, 115
"s:\Documents\GitHub\ProStartup-Learn\courses\cs\html\html103\01-cs-introduction.html", "HTML", 39, 4, 0, 43
"s:\Documents\GitHub\ProStartup-Learn\courses\cs\html\html103\02-form-basics.html", "HTML", 89, 4, 0, 93
"s:\Documents\GitHub\ProStartup-Learn\courses\cs\html\html103\03-text-form-example01.html", "HTML", 14, 0, 0, 14
"s:\Documents\GitHub\ProStartup-Learn\courses\cs\html\html103\03-text-form-example02.html", "HTML", 15, 0, 0, 15
"s:\Documents\GitHub\ProStartup-Learn\courses\cs\html\html103\03-text-form-example03.html", "HTML", 15, 0, 0, 15
"s:\Documents\GitHub\ProStartup-Learn\courses\cs\html\html103\03-text-form-example04.html", "HTML", 15, 0, 0, 15
"s:\Documents\GitHub\ProStartup-Learn\courses\cs\html\html103\03-text-form.html", "HTML", 141, 4, 0, 145
"s:\Documents\GitHub\ProStartup-Learn\courses\cs\html\html103\04-basic-input-atts-example01.html", "HTML", 14, 0, 0, 14
"s:\Documents\GitHub\ProStartup-Learn\courses\cs\html\html103\04-basic-input-atts-example02.html", "HTML", 14, 0, 0, 14
"s:\Documents\GitHub\ProStartup-Learn\courses\cs\html\html103\04-basic-input-atts-example03.html", "HTML", 15, 0, 0, 15
"s:\Documents\GitHub\ProStartup-Learn\courses\cs\html\html103\04-basic-input-atts-example04.html", "HTML", 14, 0, 0, 14
"s:\Documents\GitHub\ProStartup-Learn\courses\cs\html\html103\04-basic-input-atts.html", "HTML", 109, 4, 0, 113
"s:\Documents\GitHub\ProStartup-Learn\courses\cs\html\html103\05-fieldset-and-legend-example01.html", "HTML", 18, 0, 0, 18
"s:\Documents\GitHub\ProStartup-Learn\courses\cs\html\html103\05-fieldset-and-legend-example02.html", "HTML", 19, 0, 0, 19
"s:\Documents\GitHub\ProStartup-Learn\courses\cs\html\html103\05-fieldset-and-legend.html", "HTML", 89, 4, 0, 93
"s:\Documents\GitHub\ProStartup-Learn\courses\cs\html\html103\06-textarea-example01.html", "HTML", 18, 0, 0, 18
"s:\Documents\GitHub\ProStartup-Learn\courses\cs\html\html103\06-textarea.html", "HTML", 74, 4, 0, 78
"s:\Documents\GitHub\ProStartup-Learn\courses\cs\html\html103\07-checkbox-example01.html", "HTML", 22, 0, 0, 22
"s:\Documents\GitHub\ProStartup-Learn\courses\cs\html\html103\07-checkbox-example02.html", "HTML", 20, 0, 0, 20
"s:\Documents\GitHub\ProStartup-Learn\courses\cs\html\html103\07-checkbox.html", "HTML", 94, 4, 0, 98
"s:\Documents\GitHub\ProStartup-Learn\courses\cs\html\html103\08-radio-example01.html", "HTML", 23, 0, 0, 23
"s:\Documents\GitHub\ProStartup-Learn\courses\cs\html\html103\08-radio.html", "HTML", 72, 4, 0, 76
"s:\Documents\GitHub\ProStartup-Learn\courses\cs\html\html103\09-select-form-example01.html", "HTML", 19, 0, 0, 19
"s:\Documents\GitHub\ProStartup-Learn\courses\cs\html\html103\09-select-form-example02.html", "HTML", 24, 0, 0, 24
"s:\Documents\GitHub\ProStartup-Learn\courses\cs\html\html103\09-select-form.html", "HTML", 110, 4, 0, 114
"s:\Documents\GitHub\ProStartup-Learn\courses\cs\html\html103\10-next.html", "HTML", 38, 4, 0, 42
"s:\Documents\GitHub\ProStartup-Learn\courses\cs\html\info-multimedia\type-general.html", "HTML", 0, 0, 1, 1
"s:\Documents\GitHub\ProStartup-Learn\courses\cs\html\info-multimedia\video-youtube.html", "HTML", 66, 4, 1, 71
"s:\Documents\GitHub\ProStartup-Learn\courses\cs\html\list\0-elements-list-category.html", "HTML", 1095, 4, 0, 1099
"s:\Documents\GitHub\ProStartup-Learn\courses\cs\html\list\0-elements-list.html", "HTML", 952, 4, 0, 956
"s:\Documents\GitHub\ProStartup-Learn\courses\cs\html\list\0-global-attribute-list.html", "HTML", 0, 0, 1, 1
"s:\Documents\GitHub\ProStartup-Learn\courses\cs\html\list\att-1-dir-global.html", "HTML", 0, 0, 1, 1
"s:\Documents\GitHub\ProStartup-Learn\courses\cs\html\list\att-1-height-and-width-global.html", "HTML", 36, 4, 0, 40
"s:\Documents\GitHub\ProStartup-Learn\courses\cs\html\list\att-1-id-global.html", "HTML", 0, 0, 1, 1
"s:\Documents\GitHub\ProStartup-Learn\courses\cs\html\list\att-1-lang-global.html", "HTML", 0, 0, 1, 1
"s:\Documents\GitHub\ProStartup-Learn\courses\cs\html\list\att-1-title-global.html", "HTML", 0, 0, 1, 1
"s:\Documents\GitHub\ProStartup-Learn\courses\cs\html\list\att-a-download.html", "HTML", 0, 0, 1, 1
"s:\Documents\GitHub\ProStartup-Learn\courses\cs\html\list\att-a-href.html", "HTML", 0, 0, 1, 1
"s:\Documents\GitHub\ProStartup-Learn\courses\cs\html\list\att-a-target.html", "HTML", 0, 0, 1, 1
"s:\Documents\GitHub\ProStartup-Learn\courses\cs\html\list\att-area-coords.html", "HTML", 0, 0, 1, 1
"s:\Documents\GitHub\ProStartup-Learn\courses\cs\html\list\att-area-shape.html", "HTML", 0, 0, 1, 1
"s:\Documents\GitHub\ProStartup-Learn\courses\cs\html\list\att-audio-autoplay.html", "HTML", 0, 0, 1, 1
"s:\Documents\GitHub\ProStartup-Learn\courses\cs\html\list\att-audio-controls.html", "HTML", 0, 0, 1, 1
"s:\Documents\GitHub\ProStartup-Learn\courses\cs\html\list\att-audio-controlslist.html", "HTML", 0, 0, 1, 1
"s:\Documents\GitHub\ProStartup-Learn\courses\cs\html\list\att-audio-muted.html", "HTML", 0, 0, 1, 1
"s:\Documents\GitHub\ProStartup-Learn\courses\cs\html\list\att-audio-src.html", "HTML", 0, 0, 1, 1
"s:\Documents\GitHub\ProStartup-Learn\courses\cs\html\list\att-button-autocomplete.html", "HTML", 0, 0, 1, 1
"s:\Documents\GitHub\ProStartup-Learn\courses\cs\html\list\att-button-autofocus.html", "HTML", 0, 0, 1, 1
"s:\Documents\GitHub\ProStartup-Learn\courses\cs\html\list\att-button-disabled.html", "HTML", 0, 0, 1, 1
"s:\Documents\GitHub\ProStartup-Learn\courses\cs\html\list\att-button-form.html", "HTML", 0, 0, 1, 1
"s:\Documents\GitHub\ProStartup-Learn\courses\cs\html\list\att-canvas-height-and-width.html", "HTML", 0, 0, 1, 1
"s:\Documents\GitHub\ProStartup-Learn\courses\cs\html\list\att-canvas-moz-opaque.html", "HTML", 0, 0, 1, 1
"s:\Documents\GitHub\ProStartup-Learn\courses\cs\html\list\att-data-value.html", "HTML", 0, 0, 1, 1
"s:\Documents\GitHub\ProStartup-Learn\courses\cs\html\list\att-del-cite.html", "HTML", 0, 0, 1, 1
"s:\Documents\GitHub\ProStartup-Learn\courses\cs\html\list\att-del-datetime.html", "HTML", 0, 0, 1, 1
"s:\Documents\GitHub\ProStartup-Learn\courses\cs\html\list\att-details-open.html", "HTML", 0, 0, 1, 1
"s:\Documents\GitHub\ProStartup-Learn\courses\cs\html\list\att-embed-height-and-width.html", "HTML", 0, 0, 1, 1
"s:\Documents\GitHub\ProStartup-Learn\courses\cs\html\list\att-embed-src.html", "HTML", 0, 0, 1, 1
"s:\Documents\GitHub\ProStartup-Learn\courses\cs\html\list\att-embed-type.html", "HTML", 0, 0, 1, 1
"s:\Documents\GitHub\ProStartup-Learn\courses\cs\html\list\att-fieldset-disabled.html", "HTML", 0, 0, 1, 1
"s:\Documents\GitHub\ProStartup-Learn\courses\cs\html\list\att-fieldset-form.html", "HTML", 0, 0, 1, 1
"s:\Documents\GitHub\ProStartup-Learn\courses\cs\html\list\att-form-accept-charset.html", "HTML", 0, 0, 1, 1
"s:\Documents\GitHub\ProStartup-Learn\courses\cs\html\list\att-form-action.html", "HTML", 0, 0, 1, 1
"s:\Documents\GitHub\ProStartup-Learn\courses\cs\html\list\att-form-autocapitalize.html", "HTML", 0, 0, 1, 1
"s:\Documents\GitHub\ProStartup-Learn\courses\cs\html\list\att-form-autocomplete.html", "HTML", 0, 0, 1, 1
"s:\Documents\GitHub\ProStartup-Learn\courses\cs\html\list\att-form-enctype.html", "HTML", 0, 0, 1, 1
"s:\Documents\GitHub\ProStartup-Learn\courses\cs\html\list\att-form-method.html", "HTML", 0, 0, 1, 1
"s:\Documents\GitHub\ProStartup-Learn\courses\cs\html\list\att-form-name.html", "HTML", 0, 0, 1, 1
"s:\Documents\GitHub\ProStartup-Learn\courses\cs\html\list\att-form-novalidate.html", "HTML", 0, 0, 1, 1
"s:\Documents\GitHub\ProStartup-Learn\courses\cs\html\list\att-form-rel.html", "HTML", 0, 0, 1, 1
"s:\Documents\GitHub\ProStartup-Learn\courses\cs\html\list\att-form-target.html", "HTML", 0, 0, 1, 1
"s:\Documents\GitHub\ProStartup-Learn\courses\cs\html\list\att-html-xmlns.html", "HTML", 0, 0, 1, 1
"s:\Documents\GitHub\ProStartup-Learn\courses\cs\html\list\att-iframe-allow.html", "HTML", 0, 0, 1, 1
"s:\Documents\GitHub\ProStartup-Learn\courses\cs\html\list\att-iframe-allowfullscreen.html", "HTML", 0, 0, 1, 1
"s:\Documents\GitHub\ProStartup-Learn\courses\cs\html\list\att-iframe-credentialless.html", "HTML", 0, 0, 1, 1
"s:\Documents\GitHub\ProStartup-Learn\courses\cs\html\list\att-iframe-csp.html", "HTML", 0, 0, 1, 1
"s:\Documents\GitHub\ProStartup-Learn\courses\cs\html\list\att-iframe-height-width.html", "HTML", 0, 0, 1, 1
"s:\Documents\GitHub\ProStartup-Learn\courses\cs\html\list\att-iframe-loading.html", "HTML", 0, 0, 1, 1
"s:\Documents\GitHub\ProStartup-Learn\courses\cs\html\list\att-iframe-name.html", "HTML", 0, 0, 1, 1
"s:\Documents\GitHub\ProStartup-Learn\courses\cs\html\list\att-iframe-referrerpolicy.html", "HTML", 0, 0, 1, 1
"s:\Documents\GitHub\ProStartup-Learn\courses\cs\html\list\att-iframe-sandbox.html", "HTML", 0, 0, 1, 1
"s:\Documents\GitHub\ProStartup-Learn\courses\cs\html\list\att-iframe-src.html", "HTML", 0, 0, 1, 1
"s:\Documents\GitHub\ProStartup-Learn\courses\cs\html\list\att-iframe-srcdoc.html", "HTML", 0, 0, 1, 1
"s:\Documents\GitHub\ProStartup-Learn\courses\cs\html\list\att-img-alt.html", "HTML", 0, 0, 1, 1
"s:\Documents\GitHub\ProStartup-Learn\courses\cs\html\list\att-img-crossorigin.html", "HTML", 0, 0, 1, 1
"s:\Documents\GitHub\ProStartup-Learn\courses\cs\html\list\att-img-decoding.html", "HTML", 0, 0, 1, 1
"s:\Documents\GitHub\ProStartup-Learn\courses\cs\html\list\att-img-elementtiming.html", "HTML", 0, 0, 1, 1
"s:\Documents\GitHub\ProStartup-Learn\courses\cs\html\list\att-img-fetchpriority.html", "HTML", 0, 0, 1, 1
"s:\Documents\GitHub\ProStartup-Learn\courses\cs\html\list\att-img-height-and-width.html", "HTML", 0, 0, 1, 1
"s:\Documents\GitHub\ProStartup-Learn\courses\cs\html\list\att-img-ismap.html", "HTML", 0, 0, 1, 1
"s:\Documents\GitHub\ProStartup-Learn\courses\cs\html\list\att-img-loading.html", "HTML", 0, 0, 1, 1
"s:\Documents\GitHub\ProStartup-Learn\courses\cs\html\list\att-img-referrerpolicy.html", "HTML", 0, 0, 1, 1
"s:\Documents\GitHub\ProStartup-Learn\courses\cs\html\list\att-img-src.html", "HTML", 0, 0, 1, 1
"s:\Documents\GitHub\ProStartup-Learn\courses\cs\html\list\att-img-srcset.html", "HTML", 0, 0, 1, 1
"s:\Documents\GitHub\ProStartup-Learn\courses\cs\html\list\att-img-usemap.html", "HTML", 0, 0, 1, 1
"s:\Documents\GitHub\ProStartup-Learn\courses\cs\html\list\att-input-autocomplete.html", "HTML", 0, 0, 1, 1
"s:\Documents\GitHub\ProStartup-Learn\courses\cs\html\list\att-input-checked.html", "HTML", 0, 0, 1, 1
"s:\Documents\GitHub\ProStartup-Learn\courses\cs\html\list\att-input-id.html", "HTML", 0, 0, 1, 1
"s:\Documents\GitHub\ProStartup-Learn\courses\cs\html\list\att-input-name.html", "HTML", 0, 0, 1, 1
"s:\Documents\GitHub\ProStartup-Learn\courses\cs\html\list\att-input-placeholder.html", "HTML", 0, 0, 1, 1
"s:\Documents\GitHub\ProStartup-Learn\courses\cs\html\list\att-input-required.html", "HTML", 0, 0, 1, 1
"s:\Documents\GitHub\ProStartup-Learn\courses\cs\html\list\att-input-size.html", "HTML", 0, 0, 1, 1
"s:\Documents\GitHub\ProStartup-Learn\courses\cs\html\list\att-input-type.html", "HTML", 0, 0, 1, 1
"s:\Documents\GitHub\ProStartup-Learn\courses\cs\html\list\att-input-value.html", "HTML", 0, 0, 1, 1
"s:\Documents\GitHub\ProStartup-Learn\courses\cs\html\list\att-ins-cite.html", "HTML", 0, 0, 1, 1
"s:\Documents\GitHub\ProStartup-Learn\courses\cs\html\list\att-ins-datetime.html", "HTML", 0, 0, 1, 1
"s:\Documents\GitHub\ProStartup-Learn\courses\cs\html\list\att-label-for.html", "HTML", 0, 0, 1, 1
"s:\Documents\GitHub\ProStartup-Learn\courses\cs\html\list\att-li-value.html", "HTML", 0, 0, 1, 1
"s:\Documents\GitHub\ProStartup-Learn\courses\cs\html\list\att-link-as.html", "HTML", 0, 0, 1, 1
"s:\Documents\GitHub\ProStartup-Learn\courses\cs\html\list\att-link-blocking.html", "HTML", 0, 0, 1, 1
"s:\Documents\GitHub\ProStartup-Learn\courses\cs\html\list\att-link-crossorigin.html", "HTML", 0, 0, 1, 1
"s:\Documents\GitHub\ProStartup-Learn\courses\cs\html\list\att-link-disabled.html", "HTML", 0, 0, 1, 1
"s:\Documents\GitHub\ProStartup-Learn\courses\cs\html\list\att-link-fetchpriority.html", "HTML", 0, 0, 1, 1
"s:\Documents\GitHub\ProStartup-Learn\courses\cs\html\list\att-link-href.html", "HTML", 0, 0, 1, 1
"s:\Documents\GitHub\ProStartup-Learn\courses\cs\html\list\att-link-hreflang.html", "HTML", 0, 0, 1, 1
"s:\Documents\GitHub\ProStartup-Learn\courses\cs\html\list\att-link-imagesizes.html", "HTML", 0, 0, 1, 1
"s:\Documents\GitHub\ProStartup-Learn\courses\cs\html\list\att-link-imagesrcset.html", "HTML", 0, 0, 1, 1
"s:\Documents\GitHub\ProStartup-Learn\courses\cs\html\list\att-link-integrity.html", "HTML", 0, 0, 1, 1
"s:\Documents\GitHub\ProStartup-Learn\courses\cs\html\list\att-link-media.html", "HTML", 0, 0, 1, 1
"s:\Documents\GitHub\ProStartup-Learn\courses\cs\html\list\att-link-prefetch.html", "HTML", 0, 0, 1, 1
"s:\Documents\GitHub\ProStartup-Learn\courses\cs\html\list\att-link-referrerpolicy.html", "HTML", 0, 0, 1, 1
"s:\Documents\GitHub\ProStartup-Learn\courses\cs\html\list\att-link-rel.html", "HTML", 0, 0, 1, 1
"s:\Documents\GitHub\ProStartup-Learn\courses\cs\html\list\att-link-sizes.html", "HTML", 0, 0, 1, 1
"s:\Documents\GitHub\ProStartup-Learn\courses\cs\html\list\att-link-title.html", "HTML", 0, 0, 1, 1
"s:\Documents\GitHub\ProStartup-Learn\courses\cs\html\list\att-link-type.html", "HTML", 0, 0, 1, 1
"s:\Documents\GitHub\ProStartup-Learn\courses\cs\html\list\att-link-value.html", "HTML", 0, 0, 1, 1
"s:\Documents\GitHub\ProStartup-Learn\courses\cs\html\list\att-map-name.html", "HTML", 0, 0, 1, 1
"s:\Documents\GitHub\ProStartup-Learn\courses\cs\html\list\att-meta-charset.html", "HTML", 0, 0, 1, 1
"s:\Documents\GitHub\ProStartup-Learn\courses\cs\html\list\att-meta-content.html", "HTML", 0, 0, 1, 1
"s:\Documents\GitHub\ProStartup-Learn\courses\cs\html\list\att-meta-http-equiv.html", "HTML", 0, 0, 1, 1
"s:\Documents\GitHub\ProStartup-Learn\courses\cs\html\list\att-meter-high.html", "HTML", 0, 0, 1, 1
"s:\Documents\GitHub\ProStartup-Learn\courses\cs\html\list\att-meter-low.html", "HTML", 0, 0, 1, 1
"s:\Documents\GitHub\ProStartup-Learn\courses\cs\html\list\att-meter-max.html", "HTML", 0, 0, 1, 1
"s:\Documents\GitHub\ProStartup-Learn\courses\cs\html\list\att-meter-min.html", "HTML", 0, 0, 1, 1
"s:\Documents\GitHub\ProStartup-Learn\courses\cs\html\list\att-meter-optimum.html", "HTML", 0, 0, 1, 1
"s:\Documents\GitHub\ProStartup-Learn\courses\cs\html\list\att-meter-value.html", "HTML", 0, 0, 1, 1
"s:\Documents\GitHub\ProStartup-Learn\courses\cs\html\list\att-object-data.html", "HTML", 0, 0, 1, 1
"s:\Documents\GitHub\ProStartup-Learn\courses\cs\html\list\att-object-form.html", "HTML", 0, 0, 1, 1
"s:\Documents\GitHub\ProStartup-Learn\courses\cs\html\list\att-object-height.html", "HTML", 0, 0, 1, 1
"s:\Documents\GitHub\ProStartup-Learn\courses\cs\html\list\att-object-name.html", "HTML", 0, 0, 1, 1
"s:\Documents\GitHub\ProStartup-Learn\courses\cs\html\list\att-object-type.html", "HTML", 0, 0, 1, 1
"s:\Documents\GitHub\ProStartup-Learn\courses\cs\html\list\att-object-usemap.html", "HTML", 0, 0, 1, 1
"s:\Documents\GitHub\ProStartup-Learn\courses\cs\html\list\att-object-width.html", "HTML", 0, 0, 1, 1
"s:\Documents\GitHub\ProStartup-Learn\courses\cs\html\list\att-ol-reversed.html", "HTML", 0, 0, 1, 1
"s:\Documents\GitHub\ProStartup-Learn\courses\cs\html\list\att-ol-start.html", "HTML", 0, 0, 1, 1
"s:\Documents\GitHub\ProStartup-Learn\courses\cs\html\list\att-ol-type.html", "HTML", 0, 0, 1, 1
"s:\Documents\GitHub\ProStartup-Learn\courses\cs\html\list\att-optgroup-disabled.html", "HTML", 0, 0, 1, 1
"s:\Documents\GitHub\ProStartup-Learn\courses\cs\html\list\att-optgroup-label.html", "HTML", 0, 0, 1, 1
"s:\Documents\GitHub\ProStartup-Learn\courses\cs\html\list\att-option-disabled.html", "HTML", 0, 0, 1, 1
"s:\Documents\GitHub\ProStartup-Learn\courses\cs\html\list\att-option-label.html", "HTML", 0, 0, 1, 1
"s:\Documents\GitHub\ProStartup-Learn\courses\cs\html\list\att-option-selected.html", "HTML", 0, 0, 1, 1
"s:\Documents\GitHub\ProStartup-Learn\courses\cs\html\list\att-option-value.html", "HTML", 0, 0, 1, 1
"s:\Documents\GitHub\ProStartup-Learn\courses\cs\html\list\att-output-for.html", "HTML", 0, 0, 1, 1
"s:\Documents\GitHub\ProStartup-Learn\courses\cs\html\list\att-output-form.html", "HTML", 0, 0, 1, 1
"s:\Documents\GitHub\ProStartup-Learn\courses\cs\html\list\att-output-name.html", "HTML", 0, 0, 1, 1
"s:\Documents\GitHub\ProStartup-Learn\courses\cs\html\list\att-portal-referrerpolicy.html", "HTML", 0, 0, 1, 1
"s:\Documents\GitHub\ProStartup-Learn\courses\cs\html\list\att-portal-src.html", "HTML", 0, 0, 1, 1
"s:\Documents\GitHub\ProStartup-Learn\courses\cs\html\list\att-progress-max.html", "HTML", 0, 0, 1, 1
"s:\Documents\GitHub\ProStartup-Learn\courses\cs\html\list\att-progress-value.html", "HTML", 0, 0, 1, 1
"s:\Documents\GitHub\ProStartup-Learn\courses\cs\html\list\att-q-cite.html", "HTML", 0, 0, 1, 1
"s:\Documents\GitHub\ProStartup-Learn\courses\cs\html\list\att-script-blocking.html", "HTML", 0, 0, 1, 1
"s:\Documents\GitHub\ProStartup-Learn\courses\cs\html\list\att-script-crossorigin.html", "HTML", 0, 0, 1, 1
"s:\Documents\GitHub\ProStartup-Learn\courses\cs\html\list\att-script-defer.html", "HTML", 0, 0, 1, 1
"s:\Documents\GitHub\ProStartup-Learn\courses\cs\html\list\att-script-fetchpriority.html", "HTML", 0, 0, 1, 1
"s:\Documents\GitHub\ProStartup-Learn\courses\cs\html\list\att-script-integrity.html", "HTML", 0, 0, 1, 1
"s:\Documents\GitHub\ProStartup-Learn\courses\cs\html\list\att-script-nomodule.html", "HTML", 0, 0, 1, 1
"s:\Documents\GitHub\ProStartup-Learn\courses\cs\html\list\att-script-nonce.html", "HTML", 0, 0, 1, 1
"s:\Documents\GitHub\ProStartup-Learn\courses\cs\html\list\att-script-referrerpolicy.html", "HTML", 0, 0, 1, 1
"s:\Documents\GitHub\ProStartup-Learn\courses\cs\html\list\att-script-src.html", "HTML", 0, 0, 1, 1
"s:\Documents\GitHub\ProStartup-Learn\courses\cs\html\list\att-script-type.html", "HTML", 0, 0, 1, 1
"s:\Documents\GitHub\ProStartup-Learn\courses\cs\html\list\att-select-autocomplete.html", "HTML", 0, 0, 1, 1
"s:\Documents\GitHub\ProStartup-Learn\courses\cs\html\list\att-select-autofocus.html", "HTML", 0, 0, 1, 1
"s:\Documents\GitHub\ProStartup-Learn\courses\cs\html\list\att-select-disabled.html", "HTML", 0, 0, 1, 1
"s:\Documents\GitHub\ProStartup-Learn\courses\cs\html\list\att-select-form.html", "HTML", 0, 0, 1, 1
"s:\Documents\GitHub\ProStartup-Learn\courses\cs\html\list\att-select-id.html", "HTML", 0, 0, 1, 1
"s:\Documents\GitHub\ProStartup-Learn\courses\cs\html\list\att-select-multiple.html", "HTML", 0, 0, 1, 1
"s:\Documents\GitHub\ProStartup-Learn\courses\cs\html\list\att-select-name.html", "HTML", 0, 0, 1, 1
"s:\Documents\GitHub\ProStartup-Learn\courses\cs\html\list\att-select-required.html", "HTML", 0, 0, 1, 1
"s:\Documents\GitHub\ProStartup-Learn\courses\cs\html\list\att-select-size.html", "HTML", 0, 0, 1, 1
"s:\Documents\GitHub\ProStartup-Learn\courses\cs\html\list\att-select-value.html", "HTML", 0, 0, 1, 1
"s:\Documents\GitHub\ProStartup-Learn\courses\cs\html\list\att-slot-name.html", "HTML", 0, 0, 1, 1
"s:\Documents\GitHub\ProStartup-Learn\courses\cs\html\list\att-source-height-width.html", "HTML", 0, 0, 1, 1
"s:\Documents\GitHub\ProStartup-Learn\courses\cs\html\list\att-source-media.html", "HTML", 0, 0, 1, 1
"s:\Documents\GitHub\ProStartup-Learn\courses\cs\html\list\att-source-sizes.html", "HTML", 0, 0, 1, 1
"s:\Documents\GitHub\ProStartup-Learn\courses\cs\html\list\att-source-src.html", "HTML", 0, 0, 1, 1
"s:\Documents\GitHub\ProStartup-Learn\courses\cs\html\list\att-source-srcset.html", "HTML", 0, 0, 1, 1
"s:\Documents\GitHub\ProStartup-Learn\courses\cs\html\list\att-source-type.html", "HTML", 0, 0, 1, 1
"s:\Documents\GitHub\ProStartup-Learn\courses\cs\html\list\att-style-media.html", "HTML", 0, 0, 1, 1
"s:\Documents\GitHub\ProStartup-Learn\courses\cs\html\list\att-style-nonce.html", "HTML", 0, 0, 1, 1
"s:\Documents\GitHub\ProStartup-Learn\courses\cs\html\list\att-style-title.html", "HTML", 0, 0, 1, 1
"s:\Documents\GitHub\ProStartup-Learn\courses\cs\html\list\att-table-autofocus.html", "HTML", 0, 0, 1, 1
"s:\Documents\GitHub\ProStartup-Learn\courses\cs\html\list\att-td-colspan.html", "HTML", 0, 0, 1, 1
"s:\Documents\GitHub\ProStartup-Learn\courses\cs\html\list\att-td-headers.html", "HTML", 0, 0, 1, 1
"s:\Documents\GitHub\ProStartup-Learn\courses\cs\html\list\att-td-rowspan.html", "HTML", 0, 0, 1, 1
"s:\Documents\GitHub\ProStartup-Learn\courses\cs\html\list\att-textarea-cols.html", "HTML", 0, 0, 1, 1
"s:\Documents\GitHub\ProStartup-Learn\courses\cs\html\list\att-textarea-disabled.html", "HTML", 0, 0, 1, 1
"s:\Documents\GitHub\ProStartup-Learn\courses\cs\html\list\att-textarea-form.html", "HTML", 0, 0, 1, 1
"s:\Documents\GitHub\ProStartup-Learn\courses\cs\html\list\att-textarea-maxlength.html", "HTML", 0, 0, 1, 1
"s:\Documents\GitHub\ProStartup-Learn\courses\cs\html\list\att-textarea-minlength.html", "HTML", 0, 0, 1, 1
"s:\Documents\GitHub\ProStartup-Learn\courses\cs\html\list\att-textarea-name.html", "HTML", 0, 0, 1, 1
"s:\Documents\GitHub\ProStartup-Learn\courses\cs\html\list\att-textarea-placeholder.html", "HTML", 0, 0, 1, 1
"s:\Documents\GitHub\ProStartup-Learn\courses\cs\html\list\att-textarea-readonly.html", "HTML", 0, 0, 1, 1
"s:\Documents\GitHub\ProStartup-Learn\courses\cs\html\list\att-textarea-required.html", "HTML", 0, 0, 1, 1
"s:\Documents\GitHub\ProStartup-Learn\courses\cs\html\list\att-textarea-rows.html", "HTML", 0, 0, 1, 1
"s:\Documents\GitHub\ProStartup-Learn\courses\cs\html\list\att-textarea-spellcheck.html", "HTML", 0, 0, 1, 1
"s:\Documents\GitHub\ProStartup-Learn\courses\cs\html\list\att-textarea-wrap.html", "HTML", 0, 0, 1, 1
"s:\Documents\GitHub\ProStartup-Learn\courses\cs\html\list\att-th-abbr.html", "HTML", 0, 0, 1, 1
"s:\Documents\GitHub\ProStartup-Learn\courses\cs\html\list\att-th-headers.html", "HTML", 0, 0, 1, 1
"s:\Documents\GitHub\ProStartup-Learn\courses\cs\html\list\att-th-scope.html", "HTML", 0, 0, 1, 1
"s:\Documents\GitHub\ProStartup-Learn\courses\cs\html\list\att-time-datetime.html", "HTML", 0, 0, 1, 1
"s:\Documents\GitHub\ProStartup-Learn\courses\cs\html\list\att-track-default.html", "HTML", 0, 0, 1, 1
"s:\Documents\GitHub\ProStartup-Learn\courses\cs\html\list\att-track-kind.html", "HTML", 0, 0, 1, 1
"s:\Documents\GitHub\ProStartup-Learn\courses\cs\html\list\att-track-label.html", "HTML", 0, 0, 1, 1
"s:\Documents\GitHub\ProStartup-Learn\courses\cs\html\list\att-track-src.html", "HTML", 0, 0, 1, 1
"s:\Documents\GitHub\ProStartup-Learn\courses\cs\html\list\att-track-srcset.html", "HTML", 0, 0, 1, 1
"s:\Documents\GitHub\ProStartup-Learn\courses\cs\html\list\att-video-autoplay.html", "HTML", 0, 0, 1, 1
"s:\Documents\GitHub\ProStartup-Learn\courses\cs\html\list\att-video-controls.html", "HTML", 0, 0, 1, 1
"s:\Documents\GitHub\ProStartup-Learn\courses\cs\html\list\att-video-controlslist.html", "HTML", 0, 0, 1, 1
"s:\Documents\GitHub\ProStartup-Learn\courses\cs\html\list\att-video-crossorigin.html", "HTML", 0, 0, 1, 1
"s:\Documents\GitHub\ProStartup-Learn\courses\cs\html\list\att-video-disablepictureinpicture.html", "HTML", 0, 0, 1, 1
"s:\Documents\GitHub\ProStartup-Learn\courses\cs\html\list\att-video-disableremoteplayback.html", "HTML", 0, 0, 1, 1
"s:\Documents\GitHub\ProStartup-Learn\courses\cs\html\list\att-video-height-and-width.html", "HTML", 0, 0, 1, 1
"s:\Documents\GitHub\ProStartup-Learn\courses\cs\html\list\att-video-loop.html", "HTML", 0, 0, 1, 1
"s:\Documents\GitHub\ProStartup-Learn\courses\cs\html\list\att-video-muted.html", "HTML", 0, 0, 1, 1
"s:\Documents\GitHub\ProStartup-Learn\courses\cs\html\list\att-video-playsinline.html", "HTML", 0, 0, 1, 1
"s:\Documents\GitHub\ProStartup-Learn\courses\cs\html\list\att-video-poster.html", "HTML", 0, 0, 1, 1
"s:\Documents\GitHub\ProStartup-Learn\courses\cs\html\list\att-video-preload.html", "HTML", 0, 0, 1, 1
"s:\Documents\GitHub\ProStartup-Learn\courses\cs\html\list\att-video-src.html", "HTML", 0, 0, 1, 1
"s:\Documents\GitHub\ProStartup-Learn\courses\cs\html\list\html3_2\att-1-border-global.html", "HTML", 0, 0, 1, 1
"s:\Documents\GitHub\ProStartup-Learn\courses\cs\html\list\html4_0\att-iframe-frameborder.html", "HTML", 0, 0, 1, 1
"s:\Documents\GitHub\ProStartup-Learn\courses\cs\html\list\tag-DOCTYPE.html", "HTML", 79, 4, 0, 83
"s:\Documents\GitHub\ProStartup-Learn\courses\cs\html\list\tag-a-EXAMPLE.html", "HTML", 11, 0, 0, 11
"s:\Documents\GitHub\ProStartup-Learn\courses\cs\html\list\tag-a-EXAMPLE02.html", "HTML", 14, 0, 0, 14
"s:\Documents\GitHub\ProStartup-Learn\courses\cs\html\list\tag-a-EXAMPLE03.html", "HTML", 11, 0, 0, 11
"s:\Documents\GitHub\ProStartup-Learn\courses\cs\html\list\tag-a-EXAMPLE04.html", "HTML", 11, 0, 0, 11
"s:\Documents\GitHub\ProStartup-Learn\courses\cs\html\list\tag-a-EXAMPLE05.html", "HTML", 11, 0, 0, 11
"s:\Documents\GitHub\ProStartup-Learn\courses\cs\html\list\tag-a-EXAMPLE06.html", "HTML", 12, 0, 0, 12
"s:\Documents\GitHub\ProStartup-Learn\courses\cs\html\list\tag-a-EXAMPLE07.html", "HTML", 11, 0, 0, 11
"s:\Documents\GitHub\ProStartup-Learn\courses\cs\html\list\tag-a.html", "HTML", 247, 4, 0, 251
"s:\Documents\GitHub\ProStartup-Learn\courses\cs\html\list\tag-abbr-EXAMPLE.html", "HTML", 11, 0, 0, 11
"s:\Documents\GitHub\ProStartup-Learn\courses\cs\html\list\tag-abbr.html", "HTML", 89, 4, 0, 93
"s:\Documents\GitHub\ProStartup-Learn\courses\cs\html\list\tag-address-EXAMPLE.html", "HTML", 15, 0, 0, 15
"s:\Documents\GitHub\ProStartup-Learn\courses\cs\html\list\tag-address.html", "HTML", 93, 4, 0, 97
"s:\Documents\GitHub\ProStartup-Learn\courses\cs\html\list\tag-area-EXAMPLE.html", "HTML", 15, 0, 0, 15
"s:\Documents\GitHub\ProStartup-Learn\courses\cs\html\list\tag-area.html", "HTML", 169, 4, 0, 173
"s:\Documents\GitHub\ProStartup-Learn\courses\cs\html\list\tag-article-EXAMPLE.html", "HTML", 13, 0, 0, 13
"s:\Documents\GitHub\ProStartup-Learn\courses\cs\html\list\tag-article-EXAMPLE02.html", "HTML", 15, 0, 0, 15
"s:\Documents\GitHub\ProStartup-Learn\courses\cs\html\list\tag-article-EXAMPLE03.html", "HTML", 24, 0, 0, 24
"s:\Documents\GitHub\ProStartup-Learn\courses\cs\html\list\tag-article.html", "HTML", 132, 4, 1, 137
"s:\Documents\GitHub\ProStartup-Learn\courses\cs\html\list\tag-aside-EXAMPLE.html", "HTML", 19, 0, 0, 19
"s:\Documents\GitHub\ProStartup-Learn\courses\cs\html\list\tag-aside.html", "HTML", 90, 4, 0, 94
"s:\Documents\GitHub\ProStartup-Learn\courses\cs\html\list\tag-audio-EXAMPLE.html", "HTML", 13, 0, 0, 13
"s:\Documents\GitHub\ProStartup-Learn\courses\cs\html\list\tag-audio-EXAMPLE02.html", "HTML", 13, 0, 0, 13
"s:\Documents\GitHub\ProStartup-Learn\courses\cs\html\list\tag-audio-EXAMPLE03.html", "HTML", 16, 0, 0, 16
"s:\Documents\GitHub\ProStartup-Learn\courses\cs\html\list\tag-audio.html", "HTML", 181, 4, 0, 185
"s:\Documents\GitHub\ProStartup-Learn\courses\cs\html\list\tag-b-EXAMPLE.html", "HTML", 11, 0, 0, 11
"s:\Documents\GitHub\ProStartup-Learn\courses\cs\html\list\tag-b.html", "HTML", 82, 4, 0, 86
"s:\Documents\GitHub\ProStartup-Learn\courses\cs\html\list\tag-base-EXAMPLE.html", "HTML", 12, 0, 0, 12
"s:\Documents\GitHub\ProStartup-Learn\courses\cs\html\list\tag-base.html", "HTML", 98, 4, 0, 102
"s:\Documents\GitHub\ProStartup-Learn\courses\cs\html\list\tag-bdi-EXAMPLE.html", "HTML", 15, 0, 0, 15
"s:\Documents\GitHub\ProStartup-Learn\courses\cs\html\list\tag-bdi-EXAMPLE02.html", "HTML", 15, 0, 0, 15
"s:\Documents\GitHub\ProStartup-Learn\courses\cs\html\list\tag-bdi.html", "HTML", 94, 4, 0, 98
"s:\Documents\GitHub\ProStartup-Learn\courses\cs\html\list\tag-bdo-EXAMPLE.html", "HTML", 12, 0, 0, 12
"s:\Documents\GitHub\ProStartup-Learn\courses\cs\html\list\tag-bdo.html", "HTML", 84, 4, 0, 88
"s:\Documents\GitHub\ProStartup-Learn\courses\cs\html\list\tag-blockquote-EXAMPLE.html", "HTML", 12, 0, 0, 12
"s:\Documents\GitHub\ProStartup-Learn\courses\cs\html\list\tag-blockquote-EXAMPLE02.html", "HTML", 12, 0, 0, 12
"s:\Documents\GitHub\ProStartup-Learn\courses\cs\html\list\tag-blockquote.html", "HTML", 113, 4, 0, 117
"s:\Documents\GitHub\ProStartup-Learn\courses\cs\html\list\tag-body-EXAMPLE.html", "HTML", 8, 0, 0, 8
"s:\Documents\GitHub\ProStartup-Learn\courses\cs\html\list\tag-body.html", "HTML", 97, 4, 0, 101
"s:\Documents\GitHub\ProStartup-Learn\courses\cs\html\list\tag-br-EXAMPLE.html", "HTML", 12, 0, 0, 12
"s:\Documents\GitHub\ProStartup-Learn\courses\cs\html\list\tag-br-EXAMPLE02.html", "HTML", 15, 0, 0, 15
"s:\Documents\GitHub\ProStartup-Learn\courses\cs\html\list\tag-br.html", "HTML", 90, 4, 0, 94
"s:\Documents\GitHub\ProStartup-Learn\courses\cs\html\list\tag-button-EXAMPLE.html", "HTML", 13, 0, 0, 13
"s:\Documents\GitHub\ProStartup-Learn\courses\cs\html\list\tag-button-EXAMPLE02.html", "HTML", 16, 0, 0, 16
"s:\Documents\GitHub\ProStartup-Learn\courses\cs\html\list\tag-button-EXAMPLE03.html", "HTML", 16, 0, 0, 16
"s:\Documents\GitHub\ProStartup-Learn\courses\cs\html\list\tag-button-EXAMPLE04.html", "HTML", 13, 0, 0, 13
"s:\Documents\GitHub\ProStartup-Learn\courses\cs\html\list\tag-button.html", "HTML", 205, 4, 0, 209
"s:\Documents\GitHub\ProStartup-Learn\courses\cs\html\list\tag-canvas.html", "HTML", 84, 4, 0, 88
"s:\Documents\GitHub\ProStartup-Learn\courses\cs\html\list\tag-caption-EXAMPLE.html", "HTML", 21, 0, 0, 21
"s:\Documents\GitHub\ProStartup-Learn\courses\cs\html\list\tag-caption.html", "HTML", 100, 4, 0, 104
"s:\Documents\GitHub\ProStartup-Learn\courses\cs\html\list\tag-cite-EXAMPLE.html", "HTML", 12, 0, 0, 12
"s:\Documents\GitHub\ProStartup-Learn\courses\cs\html\list\tag-cite-EXAMPLE02.html", "HTML", 12, 0, 0, 12
"s:\Documents\GitHub\ProStartup-Learn\courses\cs\html\list\tag-cite.html", "HTML", 98, 4, 0, 102
"s:\Documents\GitHub\ProStartup-Learn\courses\cs\html\list\tag-code-EXAMPLE.html", "HTML", 11, 0, 0, 11
"s:\Documents\GitHub\ProStartup-Learn\courses\cs\html\list\tag-code-EXAMPLE02.html", "HTML", 20, 0, 0, 20
"s:\Documents\GitHub\ProStartup-Learn\courses\cs\html\list\tag-code.html", "HTML", 105, 4, 0, 109
"s:\Documents\GitHub\ProStartup-Learn\courses\cs\html\list\tag-col-EXAMPLE.html", "HTML", 26, 0, 0, 26
"s:\Documents\GitHub\ProStartup-Learn\courses\cs\html\list\tag-col.html", "HTML", 104, 4, 0, 108
"s:\Documents\GitHub\ProStartup-Learn\courses\cs\html\list\tag-colgroup-EXAMPLE.html", "HTML", 24, 0, 0, 24
"s:\Documents\GitHub\ProStartup-Learn\courses\cs\html\list\tag-colgroup.html", "HTML", 105, 4, 0, 109
"s:\Documents\GitHub\ProStartup-Learn\courses\cs\html\list\tag-comment-EXAMPLE.html", "HTML", 12, 2, 0, 14
"s:\Documents\GitHub\ProStartup-Learn\courses\cs\html\list\tag-comment.html", "HTML", 81, 4, 0, 85
"s:\Documents\GitHub\ProStartup-Learn\courses\cs\html\list\tag-data.html", "HTML", 35, 5, 0, 40
"s:\Documents\GitHub\ProStartup-Learn\courses\cs\html\list\tag-datalist-EXAMPLE.html", "HTML", 20, 0, 0, 20
"s:\Documents\GitHub\ProStartup-Learn\courses\cs\html\list\tag-datalist-EXAMPLE02.html", "HTML", 20, 0, 0, 20
"s:\Documents\GitHub\ProStartup-Learn\courses\cs\html\list\tag-datalist-EXAMPLE03.html", "HTML", 20, 0, 0, 20
"s:\Documents\GitHub\ProStartup-Learn\courses\cs\html\list\tag-datalist-EXAMPLE04.html", "HTML", 20, 0, 0, 20
"s:\Documents\GitHub\ProStartup-Learn\courses\cs\html\list\tag-datalist.html", "HTML", 177, 4, 0, 181
"s:\Documents\GitHub\ProStartup-Learn\courses\cs\html\list\tag-dd-EXAMPLE.html", "HTML", 18, 0, 0, 18
"s:\Documents\GitHub\ProStartup-Learn\courses\cs\html\list\tag-dd.html", "HTML", 104, 4, 0, 108
"s:\Documents\GitHub\ProStartup-Learn\courses\cs\html\list\tag-del-EXAMPLE.html", "HTML", 11, 0, 0, 11
"s:\Documents\GitHub\ProStartup-Learn\courses\cs\html\list\tag-del.html", "HTML", 102, 4, 0, 106
"s:\Documents\GitHub\ProStartup-Learn\courses\cs\html\list\tag-details-EXAMPLE.html", "HTML", 18, 0, 0, 18
"s:\Documents\GitHub\ProStartup-Learn\courses\cs\html\list\tag-details.html", "HTML", 92, 4, 0, 96
"s:\Documents\GitHub\ProStartup-Learn\courses\cs\html\list\tag-dfn-EXAMPLE.html", "HTML", 11, 0, 0, 11
"s:\Documents\GitHub\ProStartup-Learn\courses\cs\html\list\tag-dfn.html", "HTML", 80, 4, 0, 84
"s:\Documents\GitHub\ProStartup-Learn\courses\cs\html\list\tag-dialog.html", "HTML", 24, 3, 0, 27
"s:\Documents\GitHub\ProStartup-Learn\courses\cs\html\list\tag-div-EXAMPLE.html", "HTML", 14, 0, 0, 14
"s:\Documents\GitHub\ProStartup-Learn\courses\cs\html\list\tag-div.html", "HTML", 86, 4, 0, 90
"s:\Documents\GitHub\ProStartup-Learn\courses\cs\html\list\tag-dl-EXAMPLE.html", "HTML", 18, 0, 0, 18
"s:\Documents\GitHub\ProStartup-Learn\courses\cs\html\list\tag-dl.html", "HTML", 96, 4, 0, 100
"s:\Documents\GitHub\ProStartup-Learn\courses\cs\html\list\tag-dt-EXAMPLE.html", "HTML", 18, 0, 0, 18
"s:\Documents\GitHub\ProStartup-Learn\courses\cs\html\list\tag-dt.html", "HTML", 103, 4, 0, 107
"s:\Documents\GitHub\ProStartup-Learn\courses\cs\html\list\tag-em-EXAMPLE.html", "HTML", 11, 0, 0, 11
"s:\Documents\GitHub\ProStartup-Learn\courses\cs\html\list\tag-em.html", "HTML", 84, 4, 0, 88
"s:\Documents\GitHub\ProStartup-Learn\courses\cs\html\list\tag-embed-EXAMPLE.html", "HTML", 11, 0, 0, 11
"s:\Documents\GitHub\ProStartup-Learn\courses\cs\html\list\tag-embed-EXAMPLE02.html", "HTML", 11, 0, 0, 11
"s:\Documents\GitHub\ProStartup-Learn\courses\cs\html\list\tag-embed-EXAMPLE03.html", "HTML", 11, 0, 0, 11
"s:\Documents\GitHub\ProStartup-Learn\courses\cs\html\list\tag-embed-EXAMPLE04.html", "HTML", 11, 0, 0, 11
"s:\Documents\GitHub\ProStartup-Learn\courses\cs\html\list\tag-embed.html", "HTML", 149, 4, 1, 154
"s:\Documents\GitHub\ProStartup-Learn\courses\cs\html\list\tag-fieldset-EXAMPLE.html", "HTML", 18, 0, 0, 18
"s:\Documents\GitHub\ProStartup-Learn\courses\cs\html\list\tag-fieldset-EXAMPLE02.html", "HTML", 19, 0, 0, 19
"s:\Documents\GitHub\ProStartup-Learn\courses\cs\html\list\tag-fieldset.html", "HTML", 145, 4, 0, 149
"s:\Documents\GitHub\ProStartup-Learn\courses\cs\html\list\tag-figcaption-EXAMPLE.html", "HTML", 17, 0, 0, 17
"s:\Documents\GitHub\ProStartup-Learn\courses\cs\html\list\tag-figcaption.html", "HTML", 91, 4, 0, 95
"s:\Documents\GitHub\ProStartup-Learn\courses\cs\html\list\tag-figure-EXAMPLE.html", "HTML", 15, 0, 0, 15
"s:\Documents\GitHub\ProStartup-Learn\courses\cs\html\list\tag-figure-EXAMPLE02.html", "HTML", 17, 0, 0, 17
"s:\Documents\GitHub\ProStartup-Learn\courses\cs\html\list\tag-figure.html", "HTML", 112, 4, 0, 116
"s:\Documents\GitHub\ProStartup-Learn\courses\cs\html\list\tag-footer-EXAMPLE.html", "HTML", 15, 0, 0, 15
"s:\Documents\GitHub\ProStartup-Learn\courses\cs\html\list\tag-footer.html", "HTML", 87, 4, 0, 91
"s:\Documents\GitHub\ProStartup-Learn\courses\cs\html\list\tag-form-EXAMPLE.html", "HTML", 15, 0, 0, 15
"s:\Documents\GitHub\ProStartup-Learn\courses\cs\html\list\tag-form.html", "HTML", 146, 4, 0, 150
"s:\Documents\GitHub\ProStartup-Learn\courses\cs\html\list\tag-head.html", "HTML", 0, 0, 1, 1
"s:\Documents\GitHub\ProStartup-Learn\courses\cs\html\list\tag-header.html", "HTML", 0, 0, 1, 1
"s:\Documents\GitHub\ProStartup-Learn\courses\cs\html\list\tag-headings.html", "HTML", 0, 0, 1, 1
"s:\Documents\GitHub\ProStartup-Learn\courses\cs\html\list\tag-hgroup.html", "HTML", 0, 0, 1, 1
"s:\Documents\GitHub\ProStartup-Learn\courses\cs\html\list\tag-hr.html", "HTML", 0, 0, 1, 1
"s:\Documents\GitHub\ProStartup-Learn\courses\cs\html\list\tag-html.html", "HTML", 0, 0, 1, 1
"s:\Documents\GitHub\ProStartup-Learn\courses\cs\html\list\tag-i.html", "HTML", 0, 0, 1, 1
"s:\Documents\GitHub\ProStartup-Learn\courses\cs\html\list\tag-iframe.html", "HTML", 0, 0, 1, 1
"s:\Documents\GitHub\ProStartup-Learn\courses\cs\html\list\tag-img.html", "HTML", 0, 0, 1, 1
"s:\Documents\GitHub\ProStartup-Learn\courses\cs\html\list\tag-input.html", "HTML", 0, 0, 1, 1
"s:\Documents\GitHub\ProStartup-Learn\courses\cs\html\list\tag-ins.html", "HTML", 0, 0, 1, 1
"s:\Documents\GitHub\ProStartup-Learn\courses\cs\html\list\tag-kbd.html", "HTML", 0, 0, 1, 1
"s:\Documents\GitHub\ProStartup-Learn\courses\cs\html\list\tag-label.html", "HTML", 0, 0, 1, 1
"s:\Documents\GitHub\ProStartup-Learn\courses\cs\html\list\tag-legend.html", "HTML", 0, 0, 1, 1
"s:\Documents\GitHub\ProStartup-Learn\courses\cs\html\list\tag-li.html", "HTML", 0, 0, 1, 1
"s:\Documents\GitHub\ProStartup-Learn\courses\cs\html\list\tag-link.html", "HTML", 0, 0, 1, 1
"s:\Documents\GitHub\ProStartup-Learn\courses\cs\html\list\tag-main.html", "HTML", 0, 0, 1, 1
"s:\Documents\GitHub\ProStartup-Learn\courses\cs\html\list\tag-map.html", "HTML", 0, 0, 1, 1
"s:\Documents\GitHub\ProStartup-Learn\courses\cs\html\list\tag-mark.html", "HTML", 0, 0, 1, 1
"s:\Documents\GitHub\ProStartup-Learn\courses\cs\html\list\tag-menu.html", "HTML", 0, 0, 1, 1
"s:\Documents\GitHub\ProStartup-Learn\courses\cs\html\list\tag-meta.html", "HTML", 0, 0, 1, 1
"s:\Documents\GitHub\ProStartup-Learn\courses\cs\html\list\tag-nav.html", "HTML", 0, 0, 1, 1
"s:\Documents\GitHub\ProStartup-Learn\courses\cs\html\list\tag-noscript.html", "HTML", 0, 0, 1, 1
"s:\Documents\GitHub\ProStartup-Learn\courses\cs\html\list\tag-object.html", "HTML", 0, 0, 1, 1
"s:\Documents\GitHub\ProStartup-Learn\courses\cs\html\list\tag-ol.html", "HTML", 0, 0, 1, 1
"s:\Documents\GitHub\ProStartup-Learn\courses\cs\html\list\tag-optgroup.html", "HTML", 0, 0, 1, 1
"s:\Documents\GitHub\ProStartup-Learn\courses\cs\html\list\tag-output.html", "HTML", 0, 0, 1, 1
"s:\Documents\GitHub\ProStartup-Learn\courses\cs\html\list\tag-p.html", "HTML", 0, 0, 1, 1
"s:\Documents\GitHub\ProStartup-Learn\courses\cs\html\list\tag-picture.html", "HTML", 0, 0, 1, 1
"s:\Documents\GitHub\ProStartup-Learn\courses\cs\html\list\tag-portal.html", "HTML", 0, 0, 1, 1
"s:\Documents\GitHub\ProStartup-Learn\courses\cs\html\list\tag-pre.html", "HTML", 0, 0, 1, 1
"s:\Documents\GitHub\ProStartup-Learn\courses\cs\html\list\tag-progress.html", "HTML", 0, 0, 1, 1
"s:\Documents\GitHub\ProStartup-Learn\courses\cs\html\list\tag-q.html", "HTML", 0, 0, 1, 1
"s:\Documents\GitHub\ProStartup-Learn\courses\cs\html\list\tag-rp.html", "HTML", 0, 0, 1, 1
"s:\Documents\GitHub\ProStartup-Learn\courses\cs\html\list\tag-rt.html", "HTML", 0, 0, 1, 1
"s:\Documents\GitHub\ProStartup-Learn\courses\cs\html\list\tag-s.html", "HTML", 0, 0, 1, 1
"s:\Documents\GitHub\ProStartup-Learn\courses\cs\html\list\tag-script.html", "HTML", 0, 0, 1, 1
"s:\Documents\GitHub\ProStartup-Learn\courses\cs\html\list\tag-section.html", "HTML", 0, 0, 1, 1
"s:\Documents\GitHub\ProStartup-Learn\courses\cs\html\list\tag-select.html", "HTML", 0, 0, 1, 1
"s:\Documents\GitHub\ProStartup-Learn\courses\cs\html\list\tag-slot.html", "HTML", 0, 0, 1, 1
"s:\Documents\GitHub\ProStartup-Learn\courses\cs\html\list\tag-small.html", "HTML", 0, 0, 1, 1
"s:\Documents\GitHub\ProStartup-Learn\courses\cs\html\list\tag-source.html", "HTML", 0, 0, 1, 1
"s:\Documents\GitHub\ProStartup-Learn\courses\cs\html\list\tag-span.html", "HTML", 0, 0, 1, 1
"s:\Documents\GitHub\ProStartup-Learn\courses\cs\html\list\tag-strong.html", "HTML", 0, 0, 1, 1
"s:\Documents\GitHub\ProStartup-Learn\courses\cs\html\list\tag-style.html", "HTML", 0, 0, 1, 1
"s:\Documents\GitHub\ProStartup-Learn\courses\cs\html\list\tag-sub.html", "HTML", 0, 0, 1, 1
"s:\Documents\GitHub\ProStartup-Learn\courses\cs\html\list\tag-sup.html", "HTML", 0, 0, 1, 1
"s:\Documents\GitHub\ProStartup-Learn\courses\cs\html\list\tag-table.html", "HTML", 0, 0, 1, 1
"s:\Documents\GitHub\ProStartup-Learn\courses\cs\html\list\tag-tbody.html", "HTML", 0, 0, 1, 1
"s:\Documents\GitHub\ProStartup-Learn\courses\cs\html\list\tag-td.html", "HTML", 0, 0, 1, 1
"s:\Documents\GitHub\ProStartup-Learn\courses\cs\html\list\tag-template.html", "HTML", 0, 0, 1, 1
"s:\Documents\GitHub\ProStartup-Learn\courses\cs\html\list\tag-textarea.html", "HTML", 0, 0, 1, 1
"s:\Documents\GitHub\ProStartup-Learn\courses\cs\html\list\tag-tfoot.html", "HTML", 0, 0, 1, 1
"s:\Documents\GitHub\ProStartup-Learn\courses\cs\html\list\tag-th.html", "HTML", 0, 0, 1, 1
"s:\Documents\GitHub\ProStartup-Learn\courses\cs\html\list\tag-thead.html", "HTML", 0, 0, 1, 1
"s:\Documents\GitHub\ProStartup-Learn\courses\cs\html\list\tag-title.html", "HTML", 0, 0, 1, 1
"s:\Documents\GitHub\ProStartup-Learn\courses\cs\html\list\tag-tr.html", "HTML", 0, 0, 1, 1
"s:\Documents\GitHub\ProStartup-Learn\courses\cs\html\list\tag-track.html", "HTML", 0, 0, 1, 1
"s:\Documents\GitHub\ProStartup-Learn\courses\cs\html\list\tag-u.html", "HTML", 0, 0, 1, 1
"s:\Documents\GitHub\ProStartup-Learn\courses\cs\html\list\tag-ul.html", "HTML", 0, 0, 1, 1
"s:\Documents\GitHub\ProStartup-Learn\courses\cs\html\list\tag-var.html", "HTML", 0, 0, 1, 1
"s:\Documents\GitHub\ProStartup-Learn\courses\cs\html\list\tag-video.html", "HTML", 0, 0, 1, 1
"s:\Documents\GitHub\ProStartup-Learn\courses\cs\html\list\tag-wbr.html", "HTML", 0, 0, 1, 1
"s:\Documents\GitHub\ProStartup-Learn\courses\cs\html\list\val-a-target-blank.html", "HTML", 0, 0, 1, 1
"s:\Documents\GitHub\ProStartup-Learn\courses\cs\html\list\val-a-target-self.html", "HTML", 0, 0, 1, 1
"s:\Documents\GitHub\ProStartup-Learn\courses\cs\html\list\val-input-type-checkbox.html", "HTML", 0, 0, 1, 1
"s:\Documents\GitHub\ProStartup-Learn\courses\cs\html\list\val-input-type-color.html", "HTML", 0, 0, 1, 1
"s:\Documents\GitHub\ProStartup-Learn\courses\cs\html\list\val-input-type-email.html", "HTML", 0, 0, 1, 1
"s:\Documents\GitHub\ProStartup-Learn\courses\cs\html\list\val-input-type-file.html", "HTML", 0, 0, 1, 1
"s:\Documents\GitHub\ProStartup-Learn\courses\cs\html\list\val-input-type-number.html", "HTML", 0, 0, 1, 1
"s:\Documents\GitHub\ProStartup-Learn\courses\cs\html\list\val-input-type-password.html", "HTML", 0, 0, 1, 1
"s:\Documents\GitHub\ProStartup-Learn\courses\cs\html\list\val-input-type-radio.html", "HTML", 0, 0, 1, 1
"s:\Documents\GitHub\ProStartup-Learn\courses\cs\html\list\val-input-type-range.html", "HTML", 0, 0, 1, 1
"s:\Documents\GitHub\ProStartup-Learn\courses\cs\html\list\val-input-type-reset.html", "HTML", 0, 0, 1, 1
"s:\Documents\GitHub\ProStartup-Learn\courses\cs\html\list\val-input-type-search.html", "HTML", 0, 0, 1, 1
"s:\Documents\GitHub\ProStartup-Learn\courses\cs\html\list\val-input-type-submit.html", "HTML", 0, 0, 1, 1
"s:\Documents\GitHub\ProStartup-Learn\courses\cs\html\list\val-input-type-tel.html", "HTML", 0, 0, 1, 1
"s:\Documents\GitHub\ProStartup-Learn\courses\cs\html\list\val-input-type-text.html", "HTML", 0, 0, 1, 1
"s:\Documents\GitHub\ProStartup-Learn\courses\cs\html\list\val-input-type-url.html", "HTML", 0, 0, 1, 1
"s:\Documents\GitHub\ProStartup-Learn\courses\cs\html\list\val-input-type.html", "HTML", 0, 0, 1, 1
"s:\Documents\GitHub\ProStartup-Learn\courses\cs\html\list\val-source-type-audio.html", "HTML", 0, 0, 1, 1
"s:\Documents\GitHub\ProStartup-Learn\courses\cs\html\list\val-source-type-image.html", "HTML", 0, 0, 1, 1
"s:\Documents\GitHub\ProStartup-Learn\courses\cs\html\list\val-source-type-video.html", "HTML", 0, 0, 1, 1
"Total", "-", 13006, 313, 290, 13609